############..
#ss..#.....###
#ss..#.b..b..#
#ss..#b####..#
#ss....w.##..#
#ss..#.#..b.##
######.##b.b.#
..#.b..b.b.b.#
..#....#.....#
..############
