........########.
........#.....w#.
........#.b#b.##.
........#.b..b#..
........##b.b.#..
#########.b.#.###
#ssss..##.b..b..#
##sss....b..b...#
#ssss..##########
#######..........
